11
95
22	4	0	0	0	0	0	0	0	3	22
22	4	0	0	0	0	0	0	0	3	22
22	4	0	0	0	0	0	0	0	3	22
22	4	0	0	0	0	0	0	0	3	22
22	4	9	0	0	0	0	0	0	3	22
5	24	24	25	0	0	0	0	23	24	6
22	4	0	0	0	0	0	0	0	3	22
22	4	0	0	0	0	0	0	0	3	22
22	4	0	0	0	0	0	0	0	3	22
22	4	0	0	23	24	25	0	0	3	22
22	4	0	0	0	0	0	0	0	3	22
22	4	0	0	0	0	0	0	0	3	22
22	4	0	0	0	0	0	0	0	3	22
22	4	11	0	0	0	0	0	0	3	22
5	24	24	25	0	0	0	0	0	3	22
22	4	0	0	0	0	0	0	10	3	22
22	4	0	0	0	0	0	23	24	24	6
22	4	0	0	0	0	0	0	0	3	22
5	24	24	25	0	0	0	0	0	3	22
22	4	0	0	0	0	0	0	0	3	22
22	4	0	0	0	0	0	0	0	3	22
22	4	0	0	0	11	0	0	0	3	22
22	4	0	0	23	24	25	0	0	3	22
22	4	0	0	0	0	0	0	0	3	22
22	4	0	0	0	0	0	0	0	3	22
22	4	0	0	0	0	0	0	0	3	22
22	4	0	0	0	0	0	0	0	3	22
22	4	0	9	0	0	0	0	0	3	22
5	24	24	25	0	0	0	0	0	3	22
22	4	0	0	0	0	0	0	0	3	22
22	4	0	0	0	0	0	10	0	3	22
22	4	0	0	0	0	0	23	24	24	6
22	4	0	0	0	0	0	0	0	3	22
22	4	0	0	0	0	0	0	0	3	22
22	4	0	23	24	25	0	0	0	3	22
22	4	0	0	0	0	0	0	0	3	22
22	4	11	0	0	0	0	0	0	3	22
5	24	24	25	0	0	0	0	0	3	22
22	4	0	0	0	0	0	0	9	3	22
22	4	0	0	0	0	0	23	24	24	6
22	4	0	0	0	0	0	0	0	3	22
22	4	0	0	0	0	0	0	0	3	22
22	4	0	0	0	0	0	0	0	3	22
22	4	0	0	0	0	0	0	0	3	22
22	4	0	0	23	24	25	0	0	3	22
22	4	0	0	0	0	0	0	0	3	22
22	4	0	0	0	0	0	0	0	3	22
22	4	0	0	0	0	0	0	0	3	22
22	4	0	0	0	0	0	0	0	3	22
22	4	9	0	0	0	0	0	0	3	22
5	24	24	25	0	0	0	0	0	3	22
22	4	0	0	0	0	0	0	0	3	22
22	4	0	0	0	0	0	0	0	3	22
22	4	0	0	0	0	0	11	0	3	22
22	4	0	0	0	0	0	23	24	24	6
22	4	0	0	0	0	0	0	0	3	22
22	4	0	0	0	0	0	0	0	3	22
22	4	0	23	25	0	0	0	0	3	22
22	4	0	0	0	0	0	0	0	3	22
22	4	0	0	0	0	0	0	0	3	22
22	4	0	0	0	0	0	0	0	3	22
22	4	0	0	0	0	10	0	0	3	22
22	4	0	0	23	24	25	0	0	3	22
22	4	0	0	0	0	0	0	0	3	22
22	4	0	0	0	0	0	0	0	3	22
22	4	23	25	0	0	0	0	0	3	22
22	4	0	0	0	0	0	0	0	3	22
22	4	0	0	0	0	0	0	0	3	22
22	4	0	0	0	0	0	0	0	3	22
22	4	0	0	0	0	0	0	0	3	22
22	4	0	0	0	23	24	25	0	3	22
22	4	0	0	0	0	0	0	0	3	22
22	4	0	0	0	0	0	0	0	3	22
22	4	0	0	0	0	0	0	0	3	22
22	4	0	11	0	0	0	0	0	3	22
5	24	24	24	25	0	0	0	0	3	22
22	4	0	0	0	0	0	0	0	3	22
22	4	0	0	0	0	0	0	0	3	22
22	4	0	0	0	0	0	0	0	3	22
22	4	0	0	0	0	0	0	0	3	22
22	4	0	23	24	24	25	0	0	3	22
22	4	0	0	0	0	0	0	0	3	22
22	4	0	0	0	0	0	0	0	3	22
22	4	0	0	0	0	0	0	0	3	22
22	4	0	0	9	0	0	0	0	3	22
5	24	24	24	24	25	0	0	0	3	22
22	4	0	0	0	0	0	0	0	3	22
22	4	0	0	0	0	0	0	0	3	22
22	4	0	0	0	0	0	0	0	3	22
22	4	0	0	0	0	0	0	0	3	22
22	4	0	0	0	0	0	23	24	24	6
22	4	0	0	0	0	0	0	0	3	22
22	4	0	0	0	0	0	0	0	3	22
22	4	9	0	13	0	0	11	0	3	22
5	21	21	21	21	21	21	21	21	21	6

