11
8
22 4 0 0 0 0 0 0 0 0 0 
22 4 0 0 0 0 0 0 0 0 0 
22 4 0 0 0 0 0 0 0 0 0 
22 4 0 0 0 0 0 0 0 0 11 
22 4 0 0 0 0 0 0 0 1 21 
22 4 0 0 0 0 0 0 0 3 22 
22 4 9 0 10 0 0 0 0 3 22 
5 21 21 21 21 21 21 21 21 21 6 
